000006:1
000008:1
000010:1
000014:1
000023:1
000027:1
000030:1
000036:1
000041:1
000050:1
000055:1
000056:1
000059:1
000063:1
000065:1
000068:1
000070:1
000072:1
000074:2
000076:2
000082:1
000085:1
000097:1
000099:1
000100:1
000110:1
